a – to, at, the f.

a que horas? - what time?

abaixo - down

abelha - bee

aberto/a - open

aborrecido/a - boring

abraçar - to embrace

abraço – embrace, hug

Abril - April

abrir - to open

abrir uma conta bancária - to open a bank account

absolutamente - absolutely

acabar - to end

acabar de - to have just done something

acariciar - to caress

acaso - chance

acaso: por acaso sabe… - do you happen to know…

acção - action

aceitar - to accept

acender - to light

acetona - polish remover

achar - to find, to think

acidente - accident m.

acima - above

acolhedor – welcoming m.

acolhedora – welcoming f.

acolher - to receive

acompanhamento - side orders

acompanhar - to go with, accompany

acontecer - to happen

acordar - to wake up, to agree

acordo - agreement

acreditar - to believe

acrescentar - to add

actividade - activity f.

actor/ator - actor

actriz/atriz - actress

actual/atual – current, present

actualmente/atualmente - at present, nowadays

açúcar - sugar

açucareiro - sugar bowl

acudam! - help!

acudir - to help (someone in distress)

adaptar - to adapt

adega - wine cellar

adeus - goodbye

adiantado/a - fast, advanced

adiantar o relógio - to put the clock forward.

aéreo/a: linha aérea - airline

adiar – to postpone, to put back

admirar - to admire

admirar-se de - to be surprised at

admitir - to admit

adoçar - to sweeten

adoecer - to get/become ill

adorar - to adore, to love very much

adormecer - to go to sleep

adquirir - acquire

adulto/a - adult

advogado/a - lawyer, barrister, advocate, solicitor

ar – air m.

aeroporto - airport

afastado/a - far (away), distant

afastar - to push aside (move away)

afiador - pencil sharpener

afiar - to sharpen

afilhado/a - godson/daughter

afinal – finally, in the end

afixar - to stick

aflito/a - desperately worried, desperately anxious

agarrar - to grasp

agência - agency

agenda - diary

agora - now

Agosto - August

agradar - to please

agradável - pleasant

agradecer - to thank

agrícola – farming, agricultural

agricultor - farmer

agricultura – farming, agriculture

água - water

água com gás - sparkling water

água sem gás - still water

água mineral - mineral water

aguarde, por favor - please wait

aguardente – special type of brandy

aguarela - watercolour

aguçador - pencil sharpener

aguçar - to sharpen

aguentar - to endure, stand, withstand, bear

águia -

agulha - needle

aí – there

ainda – still, yet

ajuda - help

ajudar - to help

alargar - to broaden, to widen

alcatifa - carpet

álcool – medical alcohol m.

aldeia - village

alegre - happy, merry

alegria - happiness, joy

além - beyond

além de – beyond that, besides, in addition

aletria - vermicelli pudding

alface - lettuce f.

alfaiate - tailor m.

alfândega - Customs

algodão - cotton m.

alguém - somebody

algum/alguma - some

alho - garlic

ali - (over) there

aliás - besides - moreover

alimentação – the feeding f.

alimentar - to feed

almoçar - to (have) lunch

almoço - lunch

almofada - pillow

alojamento - accommodation

alojar - to lodge

altar - altar m.

alto/a - high; tall

altura - height

altura: a certa altura - at some time, all of a sudden

alugar - to rent; to hire out; to let

aluguer - rent m.

aluno/a - student, pupil

amanhã - tomorrow

amar - to love

amarelo/a - yellow

amargo/a - bitter

amável - kind

ambiente - atmosphere, environment m.

ambivalente - ambivalent

ambulância - ambulance

amêijoa - cockle

ameixa - plum

amêndoa - almond

amendoeira - almond tree

amiga - (girl) friend

amigo - friend

amizade - friendship f.

amor - love m.

amoras - blackberries f.pl.

amoroso/a - loving

analisar - to analyse

análise - analysis f.

ananás - pineapple m.

andar - to walk, to ride

andar - floor m.

andar (o táxi anda depressa) - to go (the taxi is going fast)

andebol - handball m.

andorinha - swallow

anedota - anecdote - story

anestesista - anaesthetist

anfiteatro - lecture room/amphitheatre

anfitrião/anfitriã - host/hostess

animado/a - cheerful

animal - animal m.

ano - year

anterior - previous

antes - before

antes de... - before...

antigamente - in the past

antigo/a - old, antique

antipático/a - unfriendly, unpleasant, not nice

anual - yearly, annual

anunciar - to announce

aonde - where to.

apagador - board wiper; eraser m.

apagar - to put out, turn off

apaixonado/a (por) - passionate, in love (with)

apaixonar(-se) - to fall in love

apalpar - to touch

apanha - harvest

apanhar - to catch, grab

apanhar (o autocarro, comboio) - to catch (the bus, train)

apanhar uma seca - to be left waiting for a lot of time (PT slang)

aparecer - to appear, turn up

apartamento - flat

apeadeiro - train halt

apelido - surname

apenas - only

apertado/a - tight

apertar - to tighten, squeeze

apertar o cinto de segurança - fasten your seat belt

apesar de - in spite of

apetece-me... - I feel like...

apitar - to whistle, to hoot, to buzz

apontar - to make a note of

apreçar - to ask the price of

apreciar - to apreciate

aprender - to learn

aprendiz/a - apprentice

apresentador/a de televisão - tv presenter

apresentar - to present

apressado/a - in a hurry

aproveitar-se de - to take advantage of

aproximar-se de - to get near/close to

aquecedor - heater m.

aquecer - to heat

aquecimento - heating

aquele/aquela - that (see demonstrative pronouns)

aqui - here

aquilo - that (thing)

aquisição - acquisition

ar - air m.

arado - plough

aranha - spider

árbitro/a - referee, umpire

arbusto - bush

ardina - newspaper boy m.

areia - sand

arenque - herring m.

arma - weapon

armário - cupboard

armazém - store m.

arquitecto/a - architect

arquitectura - architecture

arrancar - to pull out, to start, to drive off

arranjar - to arrange

arredores - outskirts

arrefecer - to cool

arrependido/a - sorry

arroz - rice m.

arroz doce - rice pudding

arrumar - to tidy

arte - art f.

artigo - article

artista - artist

árvore - tree f.

árvore (de fruto) - (fruit) tree

asa - wing

aspecto - aspect

aspirador - vacuum cleaner m.

aspirar - to hoover

assado/a - roast

assar - to roast

assassinar - to assassinate, murder

asseado/a - neat and tidy

assembleia - assembly

assento - seat

assim - so, thus, in this/that way

assim como - just like

assim – so

Assim: mesmo assim - even so

assinar - to sign

assinatura - signature

assistência - attendance

assistente de bordo - air stewerd/ess

assistir a - to attend

assistir à aula - to attend class

associação - association

associar - to associate

assunto - subject, matter

atacar - to attack

até - even, see you!

até a - until - as far as

até que - until...+ clause

atenção - attention

atendedor de chamadas - answering machine

atender - to attend

atender o telefone - to answer the telephone

atento/a - attentive

aterrar - to land

ateu/ateia - atheist(ic)

atingir - to attain, reach

atirar - to throw

atitude - attitude f.

atleta - athlete

atletismo - athletics

atrás - back(wards), rear

atrasado/a - late

atrasar - to delay

atrasar o relógio - to put the clock back

atrasar-se - to be delayed

atraso - delay

através de - through

atravessar - to cross

atum - tuna m.

aula - class, lecture (room)

aumentar - to increase

aumento - increase

aumento de preço - increase in price

auscultador - phone receiver, head phone

autocarro - bus

automóvel - car m.

avariado/a - out of order

avenida - avenue

aventura - adventure

avião - plane

avô - grandfather m.

avó - grandmother f.

azedo/a - bitter

azeite - olive oil m.

azeitona - olive

azul - blue
bacalhau - codfish m.

bacia - basin

bagaço - grape brandy

bagagem - luggage f.

bailarino/a - dancer

baile - dance m.

bairro - suburb - neighbourhood

baixar - to drop

baixo: em baixo - downstairs

baixo: para baixo - downwards

baixo relevo - low relief

baixo/a - low - small

balança - scale

balcão - counter m.

balde - bucket

baliza - goal

banana - banana

banca - stall

banco - bank

banda desenhada - cartoon

banheira - bath(tub)

banho - bath

bancário/a - banker

baptizado/a - baptized

bar - bar

barato/a - cheap

barba - beard

barbear-se (= desfazer a barba) - to shave

barbeiro - barber

barco - boat

barra de chocolate - chocolate bar

barraca - tent, hut

barriga - belly, tummy

barulhento/a - noisy

barulho - noise

base - base, basis f.

basquetebol - basketball m.

basquetebolista - basketball player

bastante - enough

bastar - to be enough

batata - potato

bater - to beat

bater um ovo - to whisk an egg

baton - lipstick

bebé - baby

beber - to

bebida - drink

beijar - to kiss

beijo - kiss

beleza - beauty, great [BR]

belo/a - beautiful

bem - well

bem decorado/a - well decorated

bem : o bem – good, asset

bem passado – (steak) well done

bem-vindo/a - welcome

bestial - fantastic

biblioteca - library

biblioteca audio-visual - audio-visual library

bibliotecário/a - librarian

bica - black (expresso) coffee

bicho - bug

bicicleta - bicycle

bidé - bidet m.

bife - steak m.

bife grelhado - grilled steak

bigode - moustache

bilhar - billiards m.

bilhete - ticket m.

bilheteira - ticket office

biscoito - biscuit

bispo - bishop

bloco de notas - notepad

blusa - blouse

boca - mouth

bocadinho -little bit, little while, quite

bocadito - small piece

bocado - bit, while, quite

bocado: um bocado caro - quite expensive

boi - ox m.

boina - beret

bola - ball

bola de basquete - basketball

bola de futebol - football

bolacha - biscuit, cookie

bolacha de água e sal - cracker

boletim metereológico - weather report

bolo - cake

bolsa - purse, stock exchange

bolsa (de estudos) - grant / scholarship

bolsa de valores - stock exchange

bolso - pocket

bom / boa - good

bombeiros - fire brigade

bombom (de chocolate) - chocolate

boneco - doll, puppet

bonito/a - pretty, beautiful

borboleta - butterfly

bordado - embroidery

bordar - to embroider

bordo - edge

bordo: a bordo - on-board

borracha - rubber; eraser

bosque - wood

bota - boot

botão - button m.

botija (de água quente) - hot water bottle

botija de gás - gas canister

braço - arm

branco/a - white

brasa - cinder,ember

bravo/a – brave, angry, upset

brilhar - to shine

brincadeira - joke

brincar - to play, to kid, to joke

brinquedo - toy

broa - corn bread

bule de café - coffee pot

bule de chá - tea pot

buraco - hole

burro/a - dumb; (nm.) donkey, stupid

buscar - to fetch

buscar: ir buscar - to go and get
cá - here

cabeça - head

cabeleireiro - hairdresser

cabelo - hair

caber - to fit

cabine (telefónica) – booth, (telephone) box f.

cabo - cape, end

cabo: ao fim e ao cabo - in the end, afterall, at the end of the day

cabra – goat, bitch (slang)

cabrito - lamb

caça - hunting

caçar - to hunt

cachecol - scarf

cachorro - puppy

cachorro quente - hot dog

cacto - cactus

cada - each

cada um/uma - each one

cada vez mais - more and more

cadeira - chair

cadela – bitch (dog)

caderno - exercise book

café - coffee m.

café em grão - coffee beans

café instantâneo - instant coffee

cafeteira - coffee pot

cair - to fall

cais – peer, platform m.

caixa - box

caixa do correio - post box

calar(-se) - to keep quiet, shut up

calçado - footwear

calçar - to wear on one's feet

calçar as meias - to put one's socks on

calçar os sapatos - to put one's shoes on

calças - trousers

calções - shorts, pants m,

caldo - broth, soup

caldo verde - spring cabbage soup

calhar - to happen

calhar: se calhar - maybe, perhaps

caligrafia - handwriting

calmo/a - calm

calor - heat m.

cama - bed

cama de casal - double bed

cama de solteiro - single bed

camada - layer

câmara - camera; town council

camarão - prawn

cambiar - to exchange (money)

câmbio - exchange (rate)

camélia - camellia

camião/caminhão - lorry - truck m.

caminho - path

camioneta de passageiros - coach

camionete - van m

camionista - lorry driver

camisa - shirt

camisa de dormir - night gown (nightie)

camisola - cardigan - jumper

campismo - camping

campo - field, country(side)

camponês - peasant farmer

canção - song f.

cancro - cancer

candeeiro de mesa - table lamp

canela - cinnamon

caneta - pen

caneta de tinta permanente - fountain pen

canja de galinha - chicken soup

cansado/a - tired

cansativo/a - tiring

cantar - to sing

cantina - canteen

canto – song, singing, corner (inside)

cantor(a) - singer

cão (cães) - dog m.

cão pastor - shepherd dog

capa de argolas - ring binder

capa do edredon - duvet cover

capaz – able, capable

capela - chapel

capital - capital

capitalismo - capitalism

cara - face

caracol - snail m.

carácter - character

caramelo - toffee

caranguejo - crab

cardeal - cardinal

careca - bald head

caricatura - caricature

carinho - affection

carinhoso/a - affectionate

carioca - weak coffee (someone from Rio de Janeiro)

carnaval - carnival m.

carne - meat f.

carne de porco - pork meat

carne de porco assada - roast pork

carne de vaca - beef

carne fumada - smoked pork

carniceiro - butcher

caro/a - dear, expensive

carpinteiro - carpenter

carrinho - toy car; trolley

carro - car

carro (da polícia, dos bombeiros) - police car / fire engine

carta - letter

carta registada - registered letter

cartão de crédito - credit card

cartão de telefone - phone card

cartas - cards

cartaz - poster

carteira - wallet - licence

carteiro - postman

cartonista - cartoonist

carvalho - oak tree

casa - house

casa de banho - bathroom

casa do botão - botton hole

casa particular - private house

casaco – coat, jacket

casado/a - married

casal - married couple m.

casamento - marriage

casar(-se) - to marry

caso - case

casota (do cão) - dog's hut

castanha - chestnut

castanheiro - chestnut tree

castanho/a - brown

castelo - castle

catedral - cathedral f.

categoria - category

catolicismo - catholicism

católico/a - catholic

catorze - fourteen

causa - cause

causa: por causa de - because of

cavalo - horse

cavar - to dig

cave - cellar f.

caviar - caviar

cebola - onion

cedo - early

cedro - cedar

cego/a - blind

ceia - supper

ceifar - to reap

cem - one hundred

cena - scene

cenoura - carrot

centeio - rye

cento - a hundred

cento: por cento - per cent

centro - centre

centro comercial - shopping centre

cerâmica - china, ceramics

cerca de - nearly (+ num)

cereal - cereal .

cereja - cherry

cerejeira - cherry tree

certã - frying pan

certeza - certainty

certeza: com certeza – certainly, of course, sure

certo: a certa altura - at a given moment, sometime

certo/a - certain

cerveja - beer

cesto - basket

cesto dos papéis - paper basket

céu - sky m.

céu encoberto - overcast (sky)

céu nublado - cloudy sky

cevada - yeast

chá - tea m.

chalé - cottage

chaleira - kettle

chama - flame

chamada - call

chamar - to call

chaminé - chimney f.

champô - champoo

chão – floor, ground m.

chapéu - hat m.

charcutaria - delicatessen

chatear - to bother, pester

chatice – bother, bore f.

chato/a – boring, bothersome

chave - key f.

chávena - cup

chávena de chá - tea cup

chefe – chief, boss, head m.

chegada - arrival

chegar - to arrive

chegar adiantado - to arrive early / ahead of time

chegar atrasado - to arrive late

chegar cedo - to arrive early

chegar em cima da hora - to arrive just on time

chegar tarde - to arrive late

cheio/a - full

cheirar - to smell

cheiro - smell

cheque - cheque m.

cheque pré-datado - pre-dated

chequecheque sem cobertura – cheque with no funds, bounced cheque

chinelo - slipper

chocolate - chocolate m.

chocolate quente - hot chocolate

chorar - to cry, weep

chouriço - smoked sausage

chover - to rain

chover a potes – to rain cats and dogs

chumbar - to fail (an exam)

chuva - rain

chuveiro - shower (bath)

ciclismo - cycling

cidade - city, town f.

ciência - science

cigarro - cigarette

cilíndro - electric water heater, boiler

cima: de cima - from above

cima: em cima - upstairs, above

cima: em cima de - on top of

cima: para cima - up(wards)

cimo - top

cinco - five

cinema - cinema m.

cinquenta - fifty

cinto – belt

cinza - grey (BR)

cinzento/a – grey (PT)

circo - circus

cirurgião - surgeon

cirurgião plástico - plastic surgeon

ciúme - jealousy m.

ciúme: com ciúme - jealousy m.

ciumento - jealous

civil - civil

claro/a – clear, obvious

classe - class f.

clássico/a - classic(al)

cliente – client, customer m/f.

clima - climate

clínica - clinic

clube - club m.

cobertor - blanket m.

cobertor eléctrico - electric blanket

cobra - snake

código postal - post code

coelho/a - rabbit

cogumelo - mushroom

coisa - thing

coisinha - thingummy

coitadinho/a! - poor thing!

coitado/a - poor, wretched

cola - glue

colar - to stick, necklace m.

colchão - mattress m.

colecção - collection

coleccionar (selos) - to collect (stamps)

colega - colleague m/f.

colégio - college - school

colete - waistcoat, jacket m.

colheita - harvest

colher - to pick

colher - spoon f.

colher de café - coffee spoon

colher de chá - tea spoon

colher de sobremesa - dessert spoon

colher de sopa - table spoon

colina - hill

colocar - to place

colorido – colour, colouring

com - with

comandante - capitain

comboio - train

(comboio) intercidades - intercity (train)

começar - to begin

comediante - comedian

comentar - to comment

comer - to eat

comercial – commercial, business

comerciante – merchant, trader

comércio – business, commerce - trading

comício – meeting, assembly

cómico/a – comic, funny

comida - (main) meal

comida enlatada - tinned food

comigo - with me

comissão - commission f.

como – as, like, how, the way that

como: assim como - just as, as well as

cómoda - chest of drawers

cómodo/a - comfortable

companheiro/a – companion, mate

companhia - company

comparação - comparison

comparar - to compare

competente - competent

competição - competition

completamente - completely

completo/a - complete - full

complicado/a - complicated

compor - to compose

composição - essay

compota - jam

compra – purchase, buying

comprar - to buy

compras - shopping

compreender - to understand

compreensão - understanding

compreensivo/a - understanding

comprido/a - long

comprimido - tablet, pill

computador - computer m.

comunicação - communication

comunismo - communism

comunista - communist

concelho - council

concerto - concert

conclusão - conclusion f.

concordar - to agree

condição - condition

condições atmosféricas - weather conditions

confessar - to confess

conforme - according as

confortável - comfortable

confusão - confusion f.

congelador - freezer

congelar - to freeze

conhecer - to know, to meet people

conhecido/a - (well) known

conhecimento - knowledge

conjunto - group

conjunto de panelas - set of pans

connosco - with us

conseguir - to manage, to achieve, to get

conselho - advice

consertar - to mend

considerar - to consider

considerar-se - to consider oneself as...

consigo - with you, with them, with himself, with herself

constipação - cold

constipar(-se) - to catch a cold

constituição - constitution

construção - construction

construir - to construc

consulta – consultation

consultor - consultant

consumo - consumption

conta - bill, account

conta à ordem - current account

conta a prazo - savings account

conta bancária - bank account

conta corrente - current account

conta da luz - electricity bill

contabilista - accountant

contactar - to contact

contacto - contact

contar - to tell - count

contemporâneo/a - contemporary

contente - happy, content

contigo - with you

continuar - to continue, carry on

contínuo/a - continuous

conto - story

contra - against

contrário/a - contrary

contratar - to contract

contrato - contract

controle - controle m.

convencer - to convince

convencido/a - convinced, full of him/herself

conversa - conversation

conversação - conversation

conversar - to converse, talk

convidado/a - guest

convidar - to invite

conviver - to socialise

conviver - to live together

convívio - living together

convosco - with you

cooperativa - cooperative

copiar - to copy

copo - glass

copo de sumo/suco - glass of juice

cor - colour f.

cor-de-laranja - orange (coloured)

cor-de-rosa - pink

coração - heart m.

corar - to blush

corpo - body

corredor – corridor, runner m.

correio – mail, post

correio azul - first class post

correio expresso - express mail

correio registado - registered post

correios - post office

correr - to run

correspondência - correspondence

corrida - race

corrigir - to correct

cortar - to cut

cortar às/em fatias - to slice

coser - to sew, stitch

cosméticos - cosmetics

costa - coast

costas - back

costeleta - cutlet, chop

costumar - to be accustomed to

costume - custom m.

costura - sewing

costurar - to sow

costureiro/a - dressmaker

cotonete - cotton bud

cotovelo - elbow

couve - (Spring) cabbage f.

coxa - thigh

cozer - to boil

cozer - to cook

cozido - stew

cozido/a - cooked

cozinha - kitchen, cooking

cozinhar - to cook

cozinheiro/a - cook, chef

cravo – nail, carnation

crédito - credit

creme – custard,cream m.

creme amaciador - conditioner

creme de barbear - shaving cream

creme hidratante - moisturising cream

crer - to believe, think

crescer - to grow

criação - creation

criado/a – created, brought up, servant

criança - child

criar - to create, bring up

crise - crisis f.

cristão/tã - Christian

Cristianismo - Christianity

crítica – review, critic

cru/crua – raw, crude

cú – bottom, arse m.

cuecas – underpants, panties

cuidado - care

cuidado com o cão - mind the dog

cuidar de - to take care of, to look after

culpa – blameculpa: a minha culpa - my fault

cultivar - to grow, cultivate

cultura - culture

cumprir o horário - to keep to time

cumprir o prazo - to meet the deadline

cunhado/a – brother, sister-in-law

curado/a - cured

curar - to cure

curioso/a - curious

curso - course

curto/a - short

custar - to cost

custo - cost

dados - dice

dália - dahlia

dança - dance

dançar - to dance

dantes - formerly

dar - to give

dar abrigo - to shelter

dar guarida - to lodge

dar entrada no hospital - to be admitted to hospital

dar erros - to make errors

dar o troco - to give change

dar uma palestra sobre - to give a talk on

data - date

de – of, from, about

de repente - suddenly

debaixo - underneath

debaixo de – under, below something

debate - debate, discussion

débito - debit

decidir - to decide

décimo - tenth

decorar - to decorate

dedicar - to dedicate

dedo anelar - ring finger

dedo (da mão / do pé) - finger / toe

dedo indicador - index finger

dedo médio - middle finger

dedo mindinho - little finger

dedo polegar - thumb

defender - to defend

degrau – step, rung m.

deitar(-se) - to lie down

deitar fora - to thow away

deixar - to leave, allow, let

deixar levantar fervura - to bring to the boil

deixar uma mensagem - to leave a message

delicioso/a - delicious

democracia – democracy

democrata - democrat

demorado/a - slow, delayed

demorar - to delay, to slow down

dente - tooth m.

dentista - dentist

dentro - inside

dentro de - inside of, within

depender - to depend

depois - afterwards

depois de - after

depositar - to deposit

depositar um cheque - to deposit a cheque

depressa - quickly, fast

deputado – Member of Parliament

desagradável - unpleasant

desagrado - displeasure

desalojado/a - homeless

desaparecer - to disappear

desastre - disaster, accident m.

descalçar-se - to take off one's shoes, boots etc

descansar - to rest

descascar ( fruta) - to peel (fruit)

descer - to go down, descend

descida ( de temperatura) - drop ( in temperature)

descobrir - to discover, find out

desconhecer - to not know

desconhecido/a - unknown

desconto - discount

desculpe o atraso! - sorry for the delay!

desculpar - to excuse

desculpe - excuse me - pardon

desde - from

desde que - since

desejar - to wish, to want, to desire

desejo - wish, desire

desempregado/a - unemployed

desemprego - unemployment

desenhador - designer, drawer

desenhar - to design, to draw

desenho - sketch, design

desenvolver - to develop

desenvolvido/a - developed

desenvolvimento - development

desgosto - displeasure, heartbreak

desistir (de)- to stop doing something, to give up

despedimento – dismissal, sack

despedir - to dismiss, to sack

despensa - pantry

desperdiçar dinheiro - to waste money

despertador - alarm clock

despesa - expense

despir - to undress (clothing)

desportivo/a - sporting

desporto - sport

desregrado/a - unruly

desrespeito - disrespect

destinatário/a - addressee

destino - destiny

desvalorização - devaluation

desvio de obras - diversion

detective - detective

detergente - detergent

detergente da louça - washing up liquid

detergente da roupa - washing powder

determinado/a - determined

detestar - to detest, to hate

deus(a) – god, goddess

devagar - slowly

dever - to owe, shall/should, must/have to, ought to

devolver - to return

dez - ten

dezanove - nineteen

dezasseis - sixteen

dezassete - seventeen

Dezembro - December

dezoito - eighteen

dia - day m.

dia: hoje em dia - nowadays

dia: um dia - one day

diálogo – dialogue

diário/a - daily

dieta - diet

diferença - difference

diferente - different

difícil - difficult

dificuldade - difficulty

diminuir - to diminish

dinheiro - money

direcção – direction, management

director(a) - director

direito – right, law

direito/a – right(hand side)

dirigir - to direct

disciplina – subject, discipline

disco – record, disc

discordar - to disagree

discoteca – club, discotheque

discussão - discussion f.

discutir - to discuss, to argue

discutir um assunto - to discuss a subject

distância - distance

distrito - district

ditado - dictation

ditadura - dictatorship

divertido/a – amusing, fun

divertimento – amusement, fun

divertir(-se) - to amuse (oneself) - have fun

dívida - debt

dividir - to divide

dividir um apartamento - to share a flat

divisa - foreign currency

divisão – division, room f

divorciado/a – divorced, divorcee

divorciar(-se) - to get divorced

divórcio - divorce

dizer - to say, to tell

dizer: quer dizer - that means

do que - than

doçarias - cakes & sweets

doce - sweet, cake

documento - document

doença - illness

doente – ill, sick patient (n)

doer - to ache, to hurt

dois/duas - two

doméstica - housewife

doméstico/a – domestic, home related

domingo - Sunday

donde - from where , whence

dono/a - owner

dor - pain f.

dormir - to sleep

dose - serving

doutor - doctor

doutora - doctor

doze - twelve

dramaturgo/a - playwright

drogaria - drugstore

duche - shower m.

duplo - double

durante – duing, while, whilest

duro/a – hardduro: trabalho duro- hard work

dúvida - doubt

dúvida: sem dúvida - doubtlessly

duvidar - to doubt

duzentos/as - two hundred

dúzia – dozen

e - and

economia - economy

económico - economic

edifício - building

edredon - duvet

educação - education

educado/a – well-mannered, polite

educador/a infantil - child minder

educar - to educate, to bring up

efectivamente - in fact

eficiente - efficient

égua - mare

ela - she

ele - he

electricidade - electricity f.

electricista - electrician m/f.

eléctrico/a - electric; (m). tram

electrodomésticos - electrical appliances

elefante - elephant m/f.

elegante - elegant

eleger - to elect, choose

eleição - election

eleitor - elector

eleitora - elector

elemento - element

elevador - lift m.

em – in, on, at

(em) saldo - (on) sale

embarcar - to embark, to go aboard

embora - although

embora: ir-se embora - to go away, to leave

embrulhar - to wrap ( up)

ementa - menu

emergência - emergency

emigrante - emigrant

emigrar - to emigrate

empregado/a – employed, employee

empregado/a bancário/a - bank clerk

empregado/a de balcão - shop assistant

empregado/a de escritório - office clerk

empregado/a de limpeza – cleaner, made

empregado/a fabril - factory worker

empregar - to employ

emprego – job, employment

empresa – enterprise, firm, business

emprestar - to lend

empréstimo - loan

empurrar - push

Ena! - wow!

encarnado/a – red, scarlet

encerrado - (position) closed

encher - to fill

encomenda – order, parcel

encomenda postal - parcel

encomendar - to order

encontrar - to find, to meet

encontrar-se com amigos - to meet friends

encontro – encounter, meeting

encosta (da montanha) - mountain side, slope

endereço - address

enevoado/a – misty, foggy

enfeitar - to decorate

enfermaria - ward

enfermeira de serviço - duty nurse

enfermeiro/a - nurse

enfim - at last, in short

enganar - to deceive

enganar-se - to make a mistake

engano - mistake

engarrafamento – bottle-neck, bottling

engenheiro/a - engineer

engordar - to get fat

engraçado/a – funny, amusing

enguia - fresh water eel

enjoar - to sicken, be sick

enorme - enormous

enquanto - while

enredo - plot, storyline

enrolar - to roll up

ensinar - to teach

ensino - teaching

então – then, so

entender - to understand

entrada – entry, entrance

entrada proibida - no entry

entradas - starters

entrar - to enter, to go in, to get in

entre – (in) between

entregar - to hand over, deliver

entretanto – meanwhile, in the meantime

envelope - envelope m.

enviar - to send, ship

enviar (uma carta) por correio - to send (a letter) by post

enxaqueca - migraine

enxugar - to dry, to wipe

época – epoch, era, time

equilíbrio - balance

equipa / equipe - team

equipamento - equipment

errado/a - wrong

errar - to make errors, make a mistake

erro – error, mistake

erva – grass, weed

erva daninha – weed

esbanjar (dinheiro) - to waste money

escada – ladder, stair

escadas - stairs

esclarecer - to clarify

escocês – Scottish, Scotsman

escocesa – Scottish, Scotswoman

Escócia - Scotland

escola - school

escola primária - primary school

escola secundária – secondary school

escolher - to choose

escova – brush, broom

escova de cabelo - hair brush

escova de dentes - toothbrush

escovar - to sweep

escovar (o cabelo) - to brush one's hair

escrever - to write

escrever cartas - to write letters

escrever no quadro - to write on the board

escrita - writing

escritor - writer

escritora - writer

escritório - office

escudo – shield

escultor - sculptor

escultora - sculptress

escultura - sculpture

escuro/a - dark

escutar - to listen

esferográfica - Biro pen

esforço - effort

esfregão - dish cloth

esfregar - to scrub, rub

esfregona - mop

esmagar - to crush

espaço - space

espaçoso/a - spacious

espanador - duster

espanador de penas - feather duster

espantoso/a - frightful

espargo - asparagus

especial - special

especialidade - speciality

especialmente - especially

espécie – species, kind, sort f.

espectáculo - show

espelho - mirror

espera - wait

espera: à espera - waiting

esperar - to wait, to hope, to expect

esperar por - to wait for

esperto/a – clever

espírito - spirit

espuma do cabelo - hair mousse

esquecer(-se) - to forget

esquentador - water heater (gas)

esquerdo/a - right (hand)

esqui - ski

esquisito/a – strange, weird

esse/essa – that

esses/essas - those

estábulo - stable

estação - station

estação de caminhos de ferro - train station

estádio - stadium

estado - state

estagiário/a - trainee

estalagem - inn f.

estante - bookcase/music stand m.

estar - to be (temporary state)

estar à venda - to be for sale

estar adiantado - to be ahead of schedule

estar atento/a - to be attentive

estar atrasado - to be late

estar avariado - to be out of order

estar com dores - to be in pain

estar com fome - to be hungry

estar com sede - to be thirsty

estar constipado/a - to have a cold

estar de cama - to be in bed

estar desligado - to be disconnected

estar doente - to be ill

estar em promoção - to be on offer

estar em saldo - to be on sale

estar ocupado - to be engaged

estar sol - to be sunny

estátua - statue

Este - East

este/esta – this (one)

estes/estas – these (ones)

estilista - fashion designer

estilo - style

estômago - stomach

estrada - road - highway

estragado/a - spoilt

estragar - to spoil - ruin

estrangeiro/a – foreign, stranger, foreigner

estreito/a - narrow

estrela - star

estudante - student m/f

estudar - to study

estudioso/a - studious

estudo - study

estúpido/a - stupid

eu - I

eucalipto - eucaliptus tree

evidentemente - obviously

evolução - evolution

exactamente - exactly

exame - exam m.

exame escrito - written exam

exame oral - oral exam

excepção - exception

exclusivo/a - exclusive

exemplo - example

exemplo: por exemplo - for example, for instance

exercer - to exercise

exercício - exercise

exército - army

exibição - show, display

exigente - demanding

exigir - to demand

exílio - exile

existir - to exist

êxito - success; result

experiência - experience

experimentar - to try, to experiment, to experience

explicação - explanation; private tutoring

explicador - private tutor

explicadora - private tutor

explicar - to explain

exploração – exploration, exploitation

explorar - to explore, exploit

exportação – exporting, exportation

exportar - export

exposição - exhibition

expressivo/a - expressive

êxtase - ecstasy

exterior - exterior

extraordinário/a – extraordinary

fábrica - factory

faca - knife

face - cheek

fácil - easy

facilidade – ease, facility f.

facto - fact

facto: de facto - in fact, really, indeed

factura - invoice

faculdade - faculty

fala - speech, talking

falar - to talk, to speak

falar alto - to speak loud

falar baixo - to speak low

falar depressa - to speak fast

falar devagar - to speak slowly

falso/a - false

falta – lack, fault

faltar - to be missing

faltar a uma aula - to miss a class

faltar às aulas - to play truant

família - family

familiar – family, familiar

famoso/a - famous

fantástico/a - fantastic

faqueiro - cutlery set

farinha - flour

farmacêutico/a - chemist

farmácia – pharmacy, chemists

farto/a de - fed up of, sated

fascismo - fascism

fascista - fascist

fatia de bolo - slice of cake

fato - suit

fato de treino - running costume

favor - favour m.

faz - (he/she) does

fazenda - cloth, fabric, material

fazenda de algodão - cotton cloth

fazer - to do, make

fazer a barba - to shave

fazer as malas - to pack

fazer café/chá - to make coffee/tea

fazer chuva - to rain

fazer compras - to shop

fazer crochet - to crochet

fazer falta - to be necessary/needed

fazer frio - to be cold

fazer ginástica - to do gymnastics/exercise

fazer sol - to be sunny

fazer vento - to be windy

fé - faith f.

febre - fever f.

fechado/a - closed

fechado para almoço - closed for lunch

fechar - to close

feijão - bean(s) m.

feijão verde - green bean

feio/a - ugly

feira - fair; open market

feirante - open market seller

felicidade - happiness f.

feliz - happy

felizmente – fortunately, luckily

feminino/a - feminine

feriado - feast day, holiday

férias - holidays

ferida - wound

ferido/a – wounded, injured

fermento - yeast

feroz - fierce

ferro - iron

fértil - fertile

ferver - to boil, simmer

festa - party - fiesta

fêveras de porco - pork steak

Fevereiro - February

fiambre - cooked ham

ficar - to be located, to stay, to become, to be something (for a reason)

fico contente por ti – I'm happy for you

ficar de pé - to stay (remain) standing up

ficha - card, record

fichas de trabalho - work sheets

fiel - faithful

fígado - liver

figo - fig

figueira - fig tree

filha - daughter

filho - son

filmar - to film

filme – moovie, film m

fim - end m.

fim: ao fim de - at the end of

fim: ao fim e ao cabo – in the end, at the end of the day

fim-de-semana - weekend m.

finalmente – finally, at last

fino - small glass of draught beer

fino/a - fine

fio - thread

físico/a – physical, physicist

fita - film

fita métrica - measuring tape

fixar - to fix

fixe! - cool!

fixo/a - fixed

flor - flower f.

floresta - forest

florista - flower seller

fogão - stove, cooker m.

fogão - cooker

fogo - fire

folha – leaf, sheet

folha de papel - sheet of paper

fome - hunger f.

fonte – fountain, source f.

fora - outside

fora de - outside of

fora: de fora - from outside

fora: para fora - out(wards)

força – strength

força! - go on!

forma – form, shape

forma: de forma que - so that

forma (de bolo, etc) - baking tray

formação – formation, education, background, training

formar - to form

formidável - formidable

formiga - ant

forno - oven

forte - strong

fósforo - match

foto(grafia) - photo, photography

fotógrafo/a - photographer

fraco/a - weak

frade - friar, monk

frágil - fragile

framboesa - raspberry

França - France

frango - chicken

frango assado - roast chicken

frango (assado) na brasa - barbecued chicken

fraquinho/a - very weak

freguês - customer

freguesa - customer

freguesia - parish - clientele

frei - friar m.

freira - nun

frente – front, forehead f.

frente: à frente - at the front

frente: à frente de - at the front of

frente: em frente - opposite - ahead

frente: em frente de – opposite, facing

frequentar - to frequent - go often

fresco/a - fresh

frigideira - frying pan

frigorífico - fridge

frio - cold(ness)

frio/a - cold

frisumo - squash / juice

fritadeira eléctrica - electric fryer

fritar - to fry

frito/a - fried

fronha - pillowcase

fronteira - frontier

fruta - fruit

fruto - fruit

frutos secos - dried fruit

fugir - to flee, run away

fulano/a – (unknown) guy/woman

fumar - to smoke

fumo - smoke

função – function f.

funcionar - to function, to work

funcionário/a - civil servant

fundamental – fundamental, basic

fundo - bottom

fundo: no fundo - at the bottom

fundo/a - deep

furo - hole

futebol - football m.

futebolista - football player

futebolista amador - amateur football player

futebolista profissional - footballer

futuro – future

gabardine – gabardine, mac f.

gado – livestock, cattle

gajo – guy, fellow, bloke

galão - milky coffee, gallon m.

galinha – hen, chicken

galo - cock

ganhar - to win, to earn

ganso - goose

garagem - garage f.

garfo - fork

gargalhada - laughter

garoto – espresso with milk

garrafa - bottle

gás - gas m.

gasolina - petrol

gastar - to spend, to wear

gato/a - cat

gaveta - drawer

geada - frost

gel de banho/duche - bath/shower gel

gelado - ice-cream

gelado/a - frozen

gelataria - ice cream parlour

geleia - jam

gelo - ice

género – gender, type, kind, sort

genro - son-in-law

gente - people f.

gente: a gente – people, one, we

gente: toda a gente - everybody

geral - general

geral: de uma maneira geral - in general, genarally speaking

geral: em geral - in general ; generally

geralmente – often, generally

gerente - manager

gigante - giant

gim - gin

ginásio - gym

ginástica - gymnastics

gíria - slang

giro/a – cute, great, fab, terrific

giz - chalk m.

golo - goal

gordo/a - fat

gorjeta – tip, gratuity

gostar de - to like

gosto – taste, liking, pleasure

gota - drop

governanta - housekeeper

governar - to govern, to rule

governo - government

gozar - to make fun of, to enjoy

graça – grace, joke

graça: ter graça - to be funny

graças a - thanks to

grama - gramme

gramática - grammar

grande – big, great, large

gravata - tie

grave – serious, grave

grelhado/a - grilled

grelhador - grill

grelhar - to grill

greve - strike

gripe - flu f.

gritar - to shout - cry

grosso/a - thick

grupo - group

guarda – guard, police wo/man m/f.

guarda-chuva - umbrella

guarda-fatos - wardrobe

guardanapo - napkin

guardar - to keep, to put away

guerra - war

guerrear - to fight (children), to wage war

guerrilha - guerilla

guia - guide m/f.

guiar - to guide, to drive

guiché - ticket office m.

guindaste - hoist, crane m.

guitarra - guitar

guitarrista – guitarist

há - there is/are

há quanto tempo? - for how long ?

habitante - inhabitant

habitar - to inhabit

habituado/a - used to, accustomed to

habituar-se - to get used to

haver - to have, (nm.) assets

hidrângea - hydrangea

hipismo - horse riding

história – history, story

hoje - today

hoje: hoje em dia - nowadays

homem - man m.

honesto/a - honest

hóquei - hockey m.

hora – hour, time

horário - timetable

horário de funcionamento - opening hours

horário (dos comboios, etc.) - (train) timetable

horrível – horrible, terrible

horta - vegetable garden

hóspede - lodger, guest

hospedeira - air stewardess

hospital - hospital m.

hotel - hotel m.

humano/a - human

humidade – damp, humidity f.

húmido/a – damp, humid

idade - age f.

ideia - idea

ignorar - not to know, to ignore

igreja - church

igual - equal

igualdade - equality f.

ilha - islandiluminado - lighting

iluminado/a - lit

imaginação - imagination

imaginar - to imagine

imediatamente – immediately, straight away

imenso/a – huge, a lot

imortal - immortal

importação - importing

importância - importance

importante - important

importar - to import

importar-se - to mind

impossível - impossible

imposto - tax, duty

Imposto Sobre o Valor Acrescentado - Value Added Tax

imprensa - press

impressão – impression, printing f.

incêndio - fire

incluído/a - included

inclusivamente – inclusive, including

incómodo/a - uncomfortable

indicativo - area code

indivíduo - individual

indústria - industry

industrial - industrial

infantil – childish, for children

infeliz - unhappy

infelizmente – unluckily, unfortunately

inflação - inflation

informação - information

informado/a - informed

informar - to inform

inglês – English, Englishman

inglesa – English;,English woman

injecção - injection

injustiça - injustice

inquilino/a - tenant

instante - instant

instituto - institute

instrução – education, training, instruction

instrutivo/a - instructive

inteiro/a – whole, entire

inteligência - intelligence

inteligente - intelligent

interessante - interesting

interessar - to interest

interesse - interest m.

interior – interior m., internal

inútil - useless

inventar - to invent

Inverno - winter

iogurte - yoghurt

ir - to go

ir ao cinema / à discoteca - to go to the cinema/disco

ir às compras - to go shopping

ir para - to go towards

ir-se (embora) - to go away, to leave

irmã - sister

irmão - brother

israelita - Israeli

isso – that thing

isso: por isso - therefore

isto – this thing

I.V.A. - V.A.T.

já - already, now

já: para já – for now

Janeiro - January

janela - window

jantar - to have supper, supper m.

Japão - Japan

jardim - garden m.

jardineiro - gardener

jarro eléctrico - electric kettle

jeito – knack, skill, way

joelharia - jewellers

joelho - knee

jogador - player

jogadora - player

jogar - to play (see also "brincar")

jogar à bola - to play ball

jogar às escondidas - to play hide and seek

jogar damas - to play draughts

jogar futebol - to play football

jogar xadrez - to play chess

jogo - game

jogo das damas - draughts game

jogo de cartas - card game

jogo de xadrez - chess game

jornal - newspaper m.

jornalista - journalist m/f.

jovem - young

judeu - Jew(ish)

judia - Jew(ish woman)

judo - judo

juiz/ juíza - judge

julgar - to judge, to think

Julho - July

Junho - June

juntar - to join

junto/a - together

juro - interest (rate)

justiça - justice

justo/a - just – fair

lá - there

lã - wool f.

lábio - lip

laboratório - laboratory

laca (do cabelo) - hair spray

lado - side

lado: por um lado ... por outro lado - on the one hand...on the other hand

ladrar - to bark

lago - lake

lagosta - lobster

lamber - to lick

lâmina de barbear - razor blade

lâmpada - bulb, lamp, torch

lanchar - to have a snack

lanche - snack m.

lápis – pencil m.

lápis dos olhos - eye pencil

lapiseira - propelling pencil

lar - home, household

lar doce lar - home sweet home

lar para idosos - old people's home

laranja - orange

laranjeira - orange tree

lareira – fire place

largar - to let go, to loose

largo - square

largo/a - wide

lata – tin, can

lavar - to wash

lavar a louça - to do the dishes

lavar o cabelo ( = lavar a cabeça) - to wash one's hair

lavatório - washing sink, wash-bowl

lavrador - farmer

lavrar - to plough the land

leão - lion m.

legumes - vegetables m.

lei - law f.

leite - milk m.

leite chocolatado - chocolate milk

leite creme - a kind of custard desert

leite em pó - powdered milk

leiteira - milk pot

leitura - reading

lembrança – souvenir

lembrar – to remind

lembrar(-se) - to remember

lenço – scarf, handkerchief

lenço de papel - tissue

lençol – bed sheet m.

lento/a - slow

ler - to read

ler em voz alta - to read out loud

letra - wording, handwriting

levantar - to raise, to lift up

levantar dinheiro - to withdraw money

levantar um cheque - to cash a cheque

levantar-se - to get up / stand up

levar - to carry, to take away

levar ao forno durante 10 minutos - to bake for 10 minutes

levar ao lume - to heat, to boil

leve - light

lhe(s) - to him, to her, to you, (to them)

liberdade – freedom, liberty f.

lição - lesson

licença – licence, permission

liceu - secondary school m.

ligado/a – connected, on

ligar - to link, connect, switch on

limão - lemon m.

limoeiro - lemon tree

limpar - to clean

limpeza – cleaning, cleanliness

limpo/a - clean

lindo/a - pretty

língua – tongue, language

linguado - sole

linha - line, thread

linha telefónica - phone line

lírio - lily

lista - list

lista telefónica - telephone directory

literatura - literature

litro - litre

livraria - bookshop

livre - free

livreiro - bookseller

livro - book

livro de cheques - cheque book

livro de exercícios - exercise book

livro de leitura - text book

lixívia - bleech

lixo - rubbish

lobo/a - wolf

local - premises m.

localidade - locality f.

loção da barba (aftershave) - aftershave

loção de limpeza - cleansing lotion

locutor – speaker, announcer

locutor/a (de rádio) - radio announcer

locutor/a (de televisão) - tv presenter

locutora – speaker, announcer

logo – next, right away

loja - shop

longe - far

longe: longe de - far from

longo/a - long

louça – china, dishes

louro/a - fair

lua - moon

lucro - profit

lugar - place m.

lugar à janela - window seat

lugar ao corredor - aisle seat

lugar de pé - standing room

lugar livre (o lugar está livre) - free seat (the seat is free)

lugar ocupado (o lugar está ocupado) - seat taken (the seat is taken)

lugar reservado - reserved seat

lulas - squid fpl.

luta - fight

luta livre - wrestling

lutador - fighter

lutar - to fight, to struggle

luvas - gloves

luxo - luxury

luz - light f.

maçã - apple f.

macaco – monkey, car jack

maçador – boring, tedious m.

macieira - apple tree

madeira - wood

madrinha - godmother

maduro/a - mature

mãe - mother f.

magoar(-se) - to hurt, to injure

magro/a - thin

Maio - May

maior – greater, bigger, major

maior: a maior parte de - most of

maioria - majority

mais - more

mais: mais ou menos - more or less

mais: nunca mais - never again

mal - badly (adv), evil m.

mal decorado/a - badly decorated

mal passado – rear

mala - (suit)case

mala: mala de mão - handbag

malcriado/a - rude

malmequer - marigold m.

malta - people, us lot, gang

mandar - to send - order

maneira - manner - way

maneira: de maneira que - so that

manga - sleeve

manhã - morning

mania - mania - craze

manifestação - demonstration

manso/a - tame

manteiga - butter

manteigueira - butter dish

manter - to maintain - hold

mão - hand f.

mão-de-obra - labour - work force

mapa - map m.

maquilhagem - make-up

maquilhar-se (= pintar-se) - to put make-up on

máquina - machine

máquina de barbear - electric shaver

máquina de lavar louça - dishwasher

máquina de lavar roupa - washing machine

maquinista - train driver

mar - sea m.

maracujá - passion fruit

maravilhoso/a - marvellous, wonderful

marcar - to make an appointment

marcar a data - to set the date

marcar o número - to dial the number

marceneiro - cabinet-maker, joiner

Março - March

marco de correio - post box

margarina - margarine

margem - river bank

marido - husband

marinheiro - sailor

marisco - sea food, shellfish

martelo - hammer

mas - but

masculino - masculine - male

massa - pasta, dough

mastigar - to chew

matar - to kill

matéria - matter

material - material m.

mato - bush, scrub

mau/má - bad

máximo/a - maximum

me - me

mecânico/a - mechanic(al)

média – average, media

medicamento - medicine

medicina - medicine

médico de serviço - duty doctor

médico/a - doctor

médico/a de clínica geral - general practitioner

medida - measure

medida: na medida em que - as far as

médio/a – medium, average, mean

medir - to measure

medo - fear

meia dúzia - half a dozen

meia-noite - midnight f.

meias – socks, stockings

meigo/a - gentle

meio cento - fifty

meio: no meio de - in the middle of

meio-dia - midday m.

meio/a - half

melancia - water melon

melão - melon m.

melhor - better

melhorar - to improve

melhoria - improvement

melro - blackbird

Membro do Parlamento - Member of Parliament

membros - limbs

memória - memory

menino/a - child boy/girl

menor – smaller, smallest, minor, least

menos – less, minus

menos: pelo menos - at least

mensal - monthly

mentira - lie

mentiroso/a(!) – lier, You are lying!

mercado - market

mercearia - grocer's

mês - month m.

mesa - table

mesinha de cabeceira - bedside table

mesmo: dá na mesma - it's all the same

mesmo: mesmo assim - even so

mesmo: mesmo que - even if

mesmo/a - same

metade - half

meter - to put (in)

meter (uma carta) no correio - to post (a letter)

meter-se em - to interfere

metro – metre, underground

metro de superfície - metrolink

metropolitano – tube, underground

meu/minha - mine

mexer - to move, stir

mil - thousand m.

milhão - million m.

milho - millet ,corn

militar – military, soldier m.

mim - me

mínimo/a - minimum

ministério - ministry

ministério da educação - ministry of education

ministro/a - minister

Ministro/a da Educação - Education Secretary

Ministro/a da Saúde - Health Minister/Secretary

Ministro/a das Finanças – Minister of Finance

minuto - minute

missa - mass

misturar - to mix

miúdo – small, kid

mobilado/a - fully furnished

mobilar - to furnish

mobília - furniture

mochila - haversack

moço/a – boy/girl,youth

moda - fashion

modelo - model

moderno/a - modern

modo - way

modo: de modo que - so that

moeda – coin, currency

moeda - coin

moinho - mill

molhar - to wet, soak

momento - moment

mondar - to weed

monge - monk

montanha - mountain

montanhismo (praticar) - hill walking/climbing (to do)

montar - to mount, ride

monte - mountain, hill, high woodland m.

montra - shop window

monumento - monument

morada - address, home

morango - strawberry

morar - to stay, live, dwell

morder - to bite

mordomo - butler

moreno/a - dark

morno/a - lukewarm

morrer - to die

morte - death f.

morto/a – dead, killed

mosca - fly

mosquito - mosquito

mostrar - to show

mota - motorbike

motivo – motive, reason

moto - motorbike

motor - motor m.

motorista - driver

motorizada - motorbike

móvel - piece of furniture

movimentado/a - busy

movimento - movement

muçulmano/a - moslem

mudar - to change

mudo/a - dumb

muito inteligente - very intelligent

muito/a – much, a lot, very, plenty of

mulher - woman f.

multar - to fine

multar: Ser multado - to get fined

multidão - crowd f.

multiplicar - to multiply

mundo - world

murcho/a - withered

muro - garden wall

museu - museum m.

música - music

músico/a – musician

nacional - national

nacionalidade - nationality f.

nada - nothing

nadar - to swim

nádegas - buttocks, rump

namorado/a - lover - in love

namorar - to court, go out with, to chat up

namoro - courting

não - no, not

não fumar - no smoking

não mobilado/a / por mobilar - unfurnished

nariz - nose m.

nascer - to be born

nascimento - birth

natação - swimming

Natal - Christmas m.

natural - natural

naturalidade - place of birth f.

naturalmente - naturally

natureza - nature

navio - ship - vessel

necessário/a - necessary

necessidade - necessity - need

necessitar - to need

negociar - to negotiate - do business

negócio - business

negro/a - negro - black

nem - neither...nor

nem: nem (sequer/mesmo) - not even

nenhum/a - none

nervoso/a - nervous

néspera - loquat

neto/a – grandson, daughter

nevar - to snow

neve - snow f.

nevoeiro - fog

ninguém - nobody

nível - level m.

nível: nível de vida - standard of living

no entanto – however, nevertheless

nó - knot m.

nogueira - walnut tree

noite - night f.

noite: à noite - at night

noite: de noite - by night

noivo/a – groom, bride, fiancé(e)

nome - name m.

nono/a - ninth

nora - daughter-in-law

Nordeste - North East

normal - normal

normalmente - usually

Noroeste - North West

Norte - North m.

nos – us, in the

nós – we / us

nosso/a - our

nota – note, mark

notar - to note, realizer, notice

notícia – notice, piece of news

noticiário - newscast

novamente - once again

nove - nine

novecentos/as - nine hundred

Novembro - November

noventa - ninety

novo/a - new, young

noz - (wal)nut f.

número - number

número de telefone - telephone number

nunca – never, ever

nunca: nunca mais - never again

nuvem - cloud f.

o – the, him, it

ó – hey, oy ,oh

obedecer - to obey

obra - work

obrigado/a – thank you, obliged

obrigar - to oblige

observar - to observe, watch

ocasião – occasion, chance f.

óculos - glasses

ocupado - busy

odiar - to hate

ódio - hatred

odor - smell

Oeste - West

oferecer - to offer

oficial - officer

oficina - workshop

oitavo/a - eighth

oitenta - eighty

oito - eight

oitocentos/as - eight hundred

olá – hello, hi

óleo - oil

óleo alimentar - cooking oil

olhar - to look

olhar - glance m.

olhar por - to look after

olho - eye

oliveira - olive tree

ombro - shoulder

onde - where

ontem - yesterday

onze - eleven

operação - operation

operador/a de computadores - computer operator

operário - worker

opinião - opinion f.

óptimo!/ótimo - great!, super!, fantastic!

ora - now

oração - prayer

orçamento - budget

ordem - order f.

ordenado - salary - wage

ordens - orders

orelha - ear

organização - organization

organizar - to organize

origem - origin f.

original - original

osso - bone

ou – either, or

ou...ou – either...or

ourivesaria – goldsmith's, jeweller's

ouro - gold

outono - autumn

outro: outra vez - again

outro: outras vezes - on other occasions

outro: outro dia - another time

outro: por outro lado - on the other hand

outro/a - other

Outubro - october

ouvido - ear, hearing

ouvir - to hear - listen

ouvir música - to listen to music

ovelha - sheep

ovo - egg

oxidar - to oxidise

oxigénio – oxygen

pá - spade f., mate, man, dude m.

paciência - patience

paciente - patient

pacífico/a - peaceful

padaria - bakery

padeiro/a - baker

padre - padre - father m.

padrinho/a – godfather, mother

pagamento - payment

pagamento automático - payment by Switch

pagar - to pay

pai - father m.

pais - parents mpl.

país - country m.

paisagem - landscape, scenery f.

paixão - passion f.

paladar - flavour

palavra - word

palavras-cruzadas - crossword

palestra - talk

palmeira - palm tree

palrar - to chat

panela - cooking pan

pano - cloth

pão - bread

pão de forma - sliced loaf

pão (pães) - bread m.

pão-de-ló - spounge cake

papa - pope m.

papel - paper m.

papel de carta - stationery

papel de parede - wall paper

papel higiénico - toilet paper

papel liso - blank paper

papel pautado (or de linhas) - lined paper

papel quadriculado - graph paper

papel reciclado - recycled paper

papelaria - stationer's

par - pair m.

para – to, for, towards, in order to

para: para que - so that, in order that

Parada do ônibus – bus stop (BR)

paragem - stop f.

paragem de autocarro - bus stop

Paraguai - Paraguay

paramédico/a - paramedic

parar - to stop

pardal - sparrow m.

parecer - to seem, to appear, to look like

parede (exterior, interior) - (exterior, interior) wall f.

parente - relative m/f.

parque - park m.

parte - part f.

parteira - midwife

participar - to participate

particular - private, personal

partida - departure, game, match

partido - party

partido/a - broken

partilhar - to share

partir - to leave, depart

partir - to break, to cut (bread)

partir: a partir de - from (+ place or time)

Páscoa - Easter

passado - past

passado/a – past, crazy (slang), out of date (food)

passageiro/a - passenger

passagem – passage, ticket, fare f.

passaporte - passport m.

passar - to pass, spend (time)

passar um cheque - to write a cheque

pássaro - bird

passear - to walk, ride

passear (a pé) - to walk

passear de carro, etc - to go for a drive, ride

passeio - pavement, walk, ride, drive

passo - step

passo: ao passo que - as, while

pasta de dentes - toothpaste

pastar - to graze

pastel - pastry cake m.

pastelaria - cake shop

pastor - shepherd

pastora - shepherdess

patinagem - skating

pátio - patio, backyard

pato/a - duck

patrão – boss, landlord m.

pau – wooden stick, m.

paz - peace f.

pé - foot m.

pé: a pé - on foot

pé: ao pé de - beside

peça – piece, part, play

pedir - to ask for, request

pedir emprestado - to borrow

pedir socorro - to ask for help

pedra - stone

pedreiro - stonemason

pegar (em) - to stick, to catch, take hold of

peito - chest, breast

peixaria - fishmonger's

peixe - fish m.

peixe congelado - frozen fish

peixe cozido - boiled fish

peixe fresco - fresh fish

peixe frito - fried fish

peixe-espada - swordfish m.

peixeiro/a - fish-monger

peixinhos - fish fingers

pele – skin, fur f.

pena – feather, pity, punishment

pena: ter pena - to feel pity

pena: valer a pena - to be worthy

penhasco - cliff

pensão - B&B, boarding house, board

pensar - to think, dress (wound)

penso diário - panty liner

penso higiénico - press on towel

penso rápido - plaster

pente - comb

pentear(-se) / pentear o cabelo - to comb (one's hair)

pepino - cucumber

pequenino/a - wee (one)

pequeno-almoço - breakfast

pequeno/a - small

pêra - pear

perante – before, in the presence of

perceber - to understand

perder - to lose, waste

perder (o autocarro, comboio, etc.) - to miss (the bus, train, etc.)

pereira - pear tree

perfeitamente - perfectly

perfeito/a - perfect

perfumaria - perfume shop

perfume – perfume, scent

pergunta - question

perguntar - to ask

perigoso/a - dangerous

período - period

permitir - to allow, permit

perna - leg

pertencer - to belong

perto: perto de - near to, close to

perto/a - near

peru - turkey m.

pesado/a - heavy - boring

pesar - to weigh

pesar 20 gramas de farinha - to weigh 20 grams flower

pesca - fishing

pescada - hake, whiting

pescador - fisherman m.

pescar - to fish

pescoço - neck

peso - weight

pêssego - peach

pessegueiro - peach tree

péssimo/a - awful

pessoa - person

pessoal – personal, (nm.) personnel

petróleo - oil

piada - joke

pianista - pianist

piar - to cheep

picante - spicy

picar (cebola) - to chop (onion)

pijama - pijamas m.

piloto - pilot

pimenta - pepper

pimentão - red pepper

pimento - green pepper, capsicum

pinça - tweezers

pincel - paintbrush m.

pincel de barbear - shaving brush

pingue-pongue - ping-pong

pinhal - pine grove m.

pinheiro - pine (tree)

pintar - to paint

pintar o cabelo - to dye one's hair

pinto - chick

pintor - painter

pintora - painter

pintura - paint(ing)

pior – worse, worst

piorar - to get worse

piquenique - picnic m.

pires - saucer

piscina - swimming pool

pisco – bowtie

planície - plain, prairie, tableland

plano - plan

plano/a - flat

planta - plant, sole

plantar - to plant

plástico - plastic

pó - powder m.

pobre - poor

pobreza - poverty

pocilga - pig sty

poço - well

podar - to prune

poder - to be able, power m.

poesia - poetry

poeta - poet m.

poetisa - poetess

pois – so, well, yes, yeah, ammm

polícia - police

polícia - police officer

polícia à paisana - plain clothes police officer

política – policy, politics

político/a – political, politician

poluição - pollution

poluído/a - polluted

polvo - octopus

pomar – orchard, fruit shop

pomba - dove

pombo - pigeon

ponta – point, tip

ponte - bridge

ponto - point, dot

população - population

popular – popular, of the people

por – by, through, for, via

por: por conseguinte – therefore

pôr - to put, to place

por favor - please?

por impulso - per unit (phone)

pôr o selo - to put the stamp on

pôr: pôr a mesa - to lay the table

porcaria – filth, rubbish, shit

porco – pig, pork

porque – because, why

porreiro/a – great, terrific, fantastic (EU slang)

porta - door

porta ( principal / da frente / das traseiras) – (main, front, back) door

porta-moedas - purse m.

porta-voz - spokes-person

portanto - therefore - so

portão - gate

porteiro - porter

porto - port

português - Portuguese (man)

portuguesa - Portuguese (woman)

posição - position

possibilidade - possibility f.

possível - possible

posta-restante - poste-restante

postal - postcard m.

posto – post, job, position

pouco inteligente - not very intelligent

pouco: um pouco - a little, some

pouco/a – little, few

poupar - to save, economize

pousada - inn

pousada de juventude - youth hostel

povo - people

praça – square, market

pradaria - prairie

praia - beach

prata - silver

prática - practice

praticamente - practically

praticar - to practise

praticar desporto - to practise sport

praticar hipismo - to go riding, ride

praticar natação - to swim

praticar remo - rowing

praticar/fazer montanhismo - to go hill walking or climbing

prático/a - practical

prato – plate, dish

prato fundo - bowl

prato ladeiro - flat plate

prato principal - main course

praxe - custom

prazer - pleasure

prazo – deadline, time limit, time due

precipitação - rain

precisamente - exactly, precisely

precisar - to need, require

preciso/a – necessary, exact

preço – price, cost

prédio - building

preencher - to fill in

preferir - to prefer

prego – nail, beef sandwich

preguiça - laziness

preguiçoso/a - lazy

prejudicar - to damage

prejudicial - harmful

prejuízo - damage, harm, loss

prender - to catch, arrest

preocupação - worry

preocupar(-se de) - to worry (about)

preparação - preparation

preparado/a – ready, prepared

preparar - to prepare

presente - present

presentear (dar presentes) - to give presents

preservativo - condom

presidente - president m/f.

Presidente da República – President of the Republic

pressa – haste, hurry, rush

pressentir - to feel something unconsciously, sense

prestar serviços - to provide services

prestar atenção - to pay attention

presunto - cured ham

pretender – to want, to claim, intend

preto/a - black

Primavera - Spring

primeiro/a - first

Primeiro/a Ministro - Prime Minister

primo/a - cousin

principalmente - mainly

príncipe - prince; large glass of draught beer (PT)

princípio – beginning, principle

princípio: em princípio - in principle

privado - private

problema - problem m.

processo - process

procura - search

procurar - to look for

produção - production

produtivo/a - productive

produto - product

produtor - producer

produtora - producer

produzir - to produce

professor – teacher, lecturer

Professor - professor

professor/a do ensino básico - primary teacher

professor/a primário/a - primary teacher

Professora - professor

professora – teacher, lecturer

profissão - profession f.

profissional - professional

profundo/a – deep, profound

programa - program(me) m.

proibida a entrada a estranhos - staff only

proibida a entrada a pessoas estranhas ao serviço - work staff only

proibido fumar - no smoking

proibir - to ban, prohibit

projecto - project

prometer - to promise

promoção - promotion

pronto! - finished! prepared!

pronto-a-vestir - ready-to-wear shop

pronto-socorro - emergency hospital

pronto/a - ready

propriamente – properly, exactly, strictly

propriedade - property f.

próprio/a – own, self

protestante - protestant

prova – proof, trial, test

provar - to taste, try, prove, to try on

província - province

próximo/a - next

pub – pub, bar

público/a - public

pudim - pudding

pulmão - lung m.

pulôver - pullover m.

pulso - wrist

pulverizador - perfume spray

punho - fist

puro/a - pure

puxar - to pull

quadrado/a - square

quadro - board, picture, chart, panel

qual - which

qualidade - quality f.

qualquer – any, some

quando - when

quando: de vez em quando - from time to time, sometimes

quantidade - quantity f.

quanto: quanto a – regarding, as for

quanto tempo - how long

quanto/a - how much, how many

quarenta - forty

quarta-feira - Wednesday

quarto - room

quarto (de dormir) - bedroom

quarto/a - fourth

quase - almost

quatro - four

quatrocentos/as - four hundred

que – that, which, who, what

que horas são? - what time is it?

quebrar em caso de emergência - break in case of emergency

queda de água - waterfall

queijo - cheese

queimado/a - burnt

queimar - to burn

queixar-se - to complain

queixo - chin

quem - who

quente - hot

quer...quer - either...or

querer - to want, wish

querer: quer dizer - that means

querido/a - dear

questão - question, issue, matter f.

quilo - kilo

quilómetro - kilometre

quinhentos/as - five hundred

quinta - farm

quinta-feira - Thursday

quintal - vegetable garden; back yard

quinto/a - fifth

quinze - fifteen

quotidiano – everyday

rã - toad

rádio - radio (set) m. - (broadcasting) f.

râguebi - rugby m.

raio - ray

raiz - root m.

ralhar - to tell off

ramo - branch

rapariga - girl

rapaz - boy m.

rapazinho - little boy

rápido/a – quick, fast, rapid

raposa - fox

raquete – racket, f.

raro/a – rare, unusual

rascunho - draft

rasgar - to tear

rato - mouse

razão – reason, ratio f.

real – real, royal

realidade - reality f.

realista - realist

realizador - director

realizadora - director

realizar - to direct, to bring about

realmente - really

rebanho - flock

rebuçado - candy

receber - to receive

receita – recipe, prescription

receitar - to prescribe

reclamação - claim

reclamar - to complain

recolha - collection

recordação – souvenir

recordar(-se) – to remember, to recall

recreio – break, recreation

rede - net(work) f.

rede telefónica - telephone network

redondo/a - round

redução de preços - price reduction

refeição/refeições – meal/meals f.

refeitório - refectory

reflectir - to reflect

reforma – reform, retirement

refresco - refreshment

rega - irrigation

regar - to water

regatear - to bargain

região - region f.

registar - to register, record

régua - ruler

reitor - rector m.

reivindicação - claim

rejeitar - to reject

relação - relation(ship)

relação: em relação a... - regarding...

relâmpago - lightning

relativamente - relatively

relevo - relief

religião - religion f.

religioso/a - religious - priest

relógio – watch, clock

relógio de sala - grandfather clock

relógio de pulso - wrist watch

remar - to row

remédio – remedy, alternative

remetente - sender m/f.

remo - rowing

renda - rent, revenue, income, embroidery

rendimento – income, yield, output, profit

reparar - to repair

reparar em - to notice

repetir - to repeat

repolho - cabbage

reportagem - report f.

representante - representative

representar - to represent, to act, to perform drama

repressão - repression f.

reprovar - to fail

república - republic

rés-do-chão - ground floor m.

reservar – to book, to reserve

reservar bilhete - to book a ticket

residência - residence, hall, boarding house

resolver - to solve

respeitar - to respect

respeito - respect

respirar - to breathe

responder - to reply, to answer

responsabilidade - responsibility f.

resposta - answer, reply

restaurante - restaurant m.

restaurar - to restore

resto – rest, remaining

resto: de resto – apart from that

resultado - result

retrete - toilet m.

retrosaria – haberdashery

reunião - meeting f.

reunir-se - to meet

revisão - revision

revista - magazine - review

revolução - revolution

rezar - to pray

rico /a - rich

rímel - mascara

rio - river

riqueza - wealth

rir(-se) - to laugh

rissol - rissole

rissol de bacalhau - cod rissole

rissol de camarão - prawn rissole

rissol de carne - meat rissole

roda - wheel

romã - pomegranate

rosa - rose

roseira - rosebush

roto/a – torn, broken

roubar - to rob, steal

roupa – clothes, garment, outfit

roupa de cama - bed linen

roupão - dressing gown

roxo/a - purple

rua - street

ruído - noise

rural – rural, country related

sábado - Saturday

sabão - soap m.

saber - to know

saber - knowledge m.

sabonete - toilet soap m.

saborear - to taste

saboroso/a – tasty, delicious

saco – sack, bag

saco de mão - handbag m.

sagrado – sacred, holy

saia - skirt

saída - exit

saída de emergência - emergency exit

sair - to go out

sair (da sala) - to leave the room

sal - salt m.

sal de mesa - table salt

sal grosso - cooking salt

sala – room, hall

sala de aula - classroom

sala de espera - waiting room

sala de estar - living room

sala de jantar - dining room

sala de leitura - reading room

sala de operações - operating theatre

salada - salad

salada de fruta - fruit salad

salada mista - mixed salad

salada russa - Russian salad

salão de chá - tea lounge

salário - salary, wage

saldo - sale (on sale)

saldo bancário - bank balance

saldo negativo - overdraft

saldo positivo - credit balance

salgadinho - small salted biscuits

salgado/a - salty

salmão fumado - smoked salmon

salsa - parsley, sauce, gravy

saltar - to jump

salto – jump, (shoe) heal

salvo - except for

salvo: salvo erro - if I am not mistaken

sandália - sandal

sandes - sandwich f.

sangrar - to bleed

sangue - blood m.

santo/a - saint - holy

sapataria - shoe shop

sapateiro - shoemaker

sapato - shoe

sardinha - sardine

satisfeito/a - satisfied

saudade – yearning, nostalgia f.

saudável - healthy

saúde - health f.

se – if, itself, himself, herself, themselves (see reflexive verbs)

sé - cathedral f.

secador de cabelo - hair dryer

secar - to dry

secar o cabelo - to dry one's hair

secção - section

seco/a - dry

secretária – secretary, desk

secretaria - secretary's office

secretário - secretary

século - century

seda - silk

seda pura - pure silk

sede – thirst, head office, headquarters f.

seguinte - following

seguir - to follow

segunda-feira - Monday

segundo – second, according to

segundo/a - second

segurança - security, safety

seguro - insurance

seguro/a - safe

seis - six

seiscentos/as - six hundred

selo - stamp

selvagem - savage

sem - without

semana - week

semanal - weekly

semear - to sow

semelhante - similar

semente - seed f.

sempre – always, still

senha – token, pre-paid ticket

senhor - sir, man, gentleman

senhora - madam, lady

senhorio/a - landlord/lady

sensato/a - sensible

sensível - sensitive

sentar-se - to sit down

sentido – sense, meaning

sentimental - sentimental

sentimento - sentiment, feeling

sentir - to feel

sentir-se mal - to feel ill

separado/a - separate(d)

separar - to separate

sequer - even

ser - to be (permanent)

ser: a não ser que- unless

ser pontual - to be punctual

ser saudável - to be healthy

série – series, serial f.

sério/a - serious

serra - mountain range, saw

serviço - service

serviço de café - coffee set

serviço de chá - tea set

serviço de urgência - casualty department

servir - to serve, be of use

servir café/chá - to serve coffee/tea

servir quente/frio - to serve hot/cold

sessenta - sixty

sete - seven

setecentos/as - seven hundred

Setembro - September

setenta - seventy

sétimo/a - seventh

seu/sua – his, her, their, your (formal)

sexo - sex

sexta-feira - Friday

sexto/a - sixth

si - himself, herself, themselves (see pronouns after preposition)

silva - bramble bush

sim - yes

simpatia – kindness, affection

simpático/a – nice, pleasant

simpatizar - to sympathize

simples - simple

simplesmente – simply, only

sinal – signal, tone, sign, down-payment, deposit m.

sinaleiro/a - traffic commander

sincero/a - sincere

sindicato - union

sítio - place

situação - situation

snack-bar - snack-bar

só – only, alone

sob - under

sobrancelha - eyebrow

sobre - on top of

sobreiro - cork oak

sobremesa - dessert

sobretudo - above all, overcoat m.

sobrinho/a – nephew, niece

social - social

socialismo - socialism

socialista - socialist

sociedade – society, company f.

sócio/a – member, partner

socorro (socorro!) - help (help!)

sofá - sofa m.

sofrer - to suffer

sogro/a - father/mother-in-law

sol - sun m.

soldado - soldier

solidariedade - solidarity f.

solteiro/a – single, bachelor, spinster

somar - to add up

sombra - shadow

sonhar - to dream

sonho - dream

sono - sleep

sopa – soup

sopa de couve - cabage soup

sopa de feijão - beans soup

sopa de legumes - vegetable soup

sopa de pedra - traditional meat and veg soup

soprar - to blow

sorte – luck, fate f.

sorte: à sorte – randomly

sossegado/a – restful, peaceful

sossego – qietness, calmness

sotão - attic

soutien - bra m.

sozinho/a – on one's own, all alone all by oneself

stand - saleroom m.

suave – soft, gentle, smooth

subida (de preços) - rise (in prices)

subir - to go up, rise, climb

subsídio - grant, subsidy

subtrair - to subtract

Suco - juice

Sudeste - South East

Sudoeste - South West

suficiente - sufficient

sujar - to dirty

sujo/a - dirty

Sul - South m.

sumo - juice

sumo de ananás - pineapple juice

sumo de laranja - orange juice

suor - sweat m.

superior – superior, higher

supermercado - supermarket

supor - to suppose

surgir - to arise, to come up

surpreender - to surprise

surpresa – surprise

tabacaria - tobacconist, kiosk
tabaco - tobacco

taberna - small pub or bar

tabuleiro - tray

taça - glass (of champagne)

tacho - short pan, pot

tal - such

talhante - butcher

talheres - cutlery m.

talho - butcher's

talo - stem

talvez - perhaps

tamanho - size

também - also, too

tangerina - mandarin

tanto/a - so much, many

tão - so

tapar - to cover

tapete - floor mat

tarde - late

tarde – late, afternoon, evening f.

tarte de maçã - apple pie

taxa de câmbio - exchange rate

taxa de juros - interest rate

táxi - taxi m.

taxista - taxi driver

te – you, to you (see pronouns)

teatro - theatre

tecido - fabric

técnica - technique

técnico/a – technical, technician

tecto - ceiling

telefonar - to phone

telefone - phone m.

telefone celular- mobile phone (BR)

telefone público - public phone, pay phone

telefonista - switchboard/telephone operator

telegrama - telegram m.

telemóvel – mobile phone (PT)

televisão - television f.

telex - telex m.

telhado - roof

tema – subject, theme, matter m.

temperatura - temperature

tempestade - storm

tempo – time, weather

temporal – storm m.

tendência - tendency

ténis - tennis m.

tenista - tennis player

tentar - to try

ter - to have

ter: ter de - to have to, must

ter alta hospitalar - to be released from hospital

ter dores - to have pain

ter dúvidas - to have doubts

ter saúde - to be healthy

ter prazer - to have pleasure

ter uma constipação - to have a cold

terça-feira - Tuesday

terceiro/a - third

terminar - to end, finish

termo – end, term

termómetro - thermometer

ternura - tenderness

terra - earth, soil, ground, land

terreno – piece of land, terrain

terrina - tureen

terrível - terrible

tesoura - (pair of) scissors

testa - forehead

testar - to test

teste - test

testo (da panela) - (pan) lid

teu/tua – your (see possessive pronouns)

texto - text

ti – you (see pronouns)

tia - aunt

tigre - tiger m.

tinta - ink

tio - uncle

típico/a - typical

tipo – type, fellow, guy

tirar - to pull out, to take out

tirar a roupa - to undress

tirar apontamentos - to make notes

tirar fotografias - to take photos

tirar nota negativa - to get a fail

tirar nota positiva - to get a pass

tirar o calçado - to take off footwear

toalha - towel

tocar - to ring (telephone) to touch, to play instruments

tocar à campainha - ring the bell

tocar guitarra - to play the guitar

toda a gente - everybody

todo/a - all

tomar - to take

tomar banho - to bath(e)

tomate - tomato m.

tornar - to turn, to become

torneira - tap

torrada - toast

torradeira - toaster

tosse - cough f.

tosta - toast

tostão - ten cents m.

totalmente - totally

toucador - dressing table

toucinho - pork fat

tourada - bullfight

toureiro - bullfighter

touro - bull

tóxico/a - toxic

trabalhador – worker, (adj) hard working/labour

trabalhadora - worker; (adj) hard working/labour

trabalhar - to work

trabalho - work

trabalho de casa - homework

trabalhoso/a - laborious

tractor - tractor m.

tranquilidade - tranquility, peacefulness

tranquilo/a - peaceful

transferência bancária - bank transfer

transferir dinheiro - to transfer money

trânsito - traffic

transporte - transport m.

transporte público - public transport

trás - behind

trás: para trás - backwards

tratamento - treatment

tratar - to treat - deal with

travar - to break

travessa - dish, tray

trazer - to bring

treinador - trainer

treinar - to train

treino - training

três - three

treze - thirteen

trezentos/as - three hundred

triangular - triangular

tricotar ( = fazer malha) - to knit

trigo - wheat

trincar - to bite off (food)

trinta - thirty

triste - sad

tristeza - sadness

trocar - to change, exchange, swap

troco - change

tronco - body, trunk

tropa – troop, army

trovão - thunder m.

trovejar - to thunder

trovoada - thunderstorm

truta - trout

tu - you

tudo – everything, it all, all of it

turismo - tourism

turista – tourist

ultimamente – lately, lastly

último/a – latest, last

ultrapassar - to overtake

um/a - one, a/an (see indefinite articles)

unha - nail

unhas (das mãos, dos pés) - (finger, toe) nails

único/a – only one, unique, sole

unidade - unity unit f.

unidade de cuidados intensivos - intensive care unit

unido/a - united

universidade - university f.

universitario/a – university related

urgente - urgent

usar - to use

usar maquilhagem - to wear make-up

utensílios de cozinha - kitchen utensils

útil - useful

utilizar - to use, utilize

uva – grape

vaca - cow

vaca leiteira - milk cow

vacina - vaccine

vaga - wave

vago/a – vague, vacant

vale – valley, voucher m.

valer - to be worth

valor - value m.

vantagem - advantage f.

vapor - steam m.

varanda - balcony

variedade - variety f.

vários/as – various, several, many

varrer - to sweep

vassoura - broom

vazio/a - empty

vela – candle, car spark plug

velho/a - old

velocidade - speed f.

venda - sale

vendedor - salesman

vendedora - saleswoman

vender - to sell

vento - wind

vento forte - strong wind

vento fraco - soft wind

ver - to see

ver televisão - to watch TV

Verão - Summer m.

verdade - truth f.

verdade : na verdade - really

verniz (das unhas) - nail polish

vestido - dress

vestir - to wear (not for shoes & socks), to dress

vestir-se - to get dressed

vez – time, turn f.

vez : às vezes - at times, sometimes

vez : cada vez – each time

vez : cada vez mais - more and more

vez : de vez em quando - from time to time

vez : em vez de - instead of

viagem – journey,trip, voyage

viajar - to travel

viajar de (avião, camioneta, comboio, etc.) - to travel by (plane, coach, train, etc.)

vice-presidente - vice-president

vida - life

videira - vine

vidro – glass

vila - town

vinagre - vinager

vindima - wine harvest

vindimar - to harvest the grapes

vinha - vineyard

vinho - wine

vinho do Porto - Port wine

vinho tinto - red wine

vinho verde – sparkling wine

vinte - twenty

violeta - violet

violinista - violinist

vir - to come, come back, return

virar - to turn

visão - vision

visita – visit, visitor

visitar - to visit

vista – sight, view

visto que - seeing that, once

vistoso/a - eye catching

vitela - veal

vítima - victim

viúvo/a – widowed, widow

viver - to live

vivo/a - alive

vizinho/a - neighbour

voar - to fly

você - you

voleibol - volleyball m.

volta – return, turn

volta : à volta de - around

voltar (a) - to return, (to do again)

vomitar - to vomit, be sick

vontade - will f.

vontade : à vontade - at ease, comfortable

vos – you (see pronouns)

vosso/a – your (guys)

votar - to vote

voto - vote

vulgar – common

xadrez - chess m.

xaile (xale) - shawl m.

xampu or xampô - shampoo

xarope - syrup m.

xerez - sherry m,

xícara - cup

xilofone – xylophone
zangar-se - to get angry

Zé - Joe (abbreviation for José)

zé: O zé-povinho - the ordinary man/the people, the tax payers (slang)

zero – zero, nothing

zona – zone, area, location

zumbir - to buzz


